###################
#oooooooo#oooooooo#
Go##o###ooo###o##o#
#o##o###ooo###o##o#
#oooooooo#oooooooo#
#o##o#o#####o#o##o#
#Oooo#ooo#ooo#oooO#
##o#o###o#o###o#o##
#oo#oooooMooooo#oo#
#o##o#o## ##o#o##o#
#oooo#o#MMM#o#oooo#
#o##o#o#####o#o##o#
#oo#o#oooHooo#o#oo#
##o#o#o#####o#o#o##
#ooooooooooooooooo#
#o##o###o#o###o##o#
#Oo#ooooo#ooooo#oOG
##o#o#o#####o#o#o##
#oooo#ooo#ooo#oooo#
#o##o###o#o###o##o#
#ooooooooooooooooo#
###################