###################
#oooooo#ooo#oooooo#
#o##o#o#o#o#o#o##o#
#oooO#ooo#ooo#Oooo#
#o##o###o#o###o##o#
#o#oooooo#oooooo#o#
#o#o## ##### ##o#o#
#oooo    M    oooo#
#o##o# ## ## #o##o#
#o##o# #MMM# #o##o#
#oooo# ##### #oooo#
# ##o#       #o## #
#  #o# ##### #o#  #
## #ooooo#ooooo# ##
#  #ooooo#ooooo#  #
# ##o###o#o###o#  #
#oooo#oooHooo#oooo#
#o#o##o#o#o#o##o#o#
#o#Oooo#ooo#oooO#o#
#o####o#####o####o#
#ooooooooooooooooo#
###################