###################
#      #   #      #
# ## # # # # # ## #
#    #   #   #    #
# ## ### # ### ## #
# #      #      # #
# # ## ##### ## # #
#        M        #
# ## # ## ## # ## #
# ## # #MMM# # ## #
#    # ##### #    #
# ## #       # ## #
#  # # ##### # #  #
## #     #     # ##
#  #     #     #  #
# ## ### # ### #  #
#    #   #        #
# # ## # # # ## # #
# #    #   #    # #
# #### ##### #### #
#       H         #
###################