###################
#cccccc#ccc#cccccc#
#c##c#c#c#c#c#c##c#
#cccs#ccc#ccc#sccc#
#c##c###c#c###c##c#
#c#cccccc#cccccc#c#
#c#c## ##### ##c#c#
#cccc    G    cccc#
#c##c# ## ## #c##c#
#c##c# #GGG# #c##c#
#cccc# ##### #cccc#
# ##c#       #c## #
#  #c# ##### #c#  #
## #ccccc#ccccc# ##
#  #ccccc#ccccc#  #
# ##c###c#c###c#  #
#cccc#cccPccc#cccc#
#c#c##c#c#c#c##c#c#
#c#sccc#ccc#cccs#c#
#c####c#####c####c#
#ccccccccccccccccc#
###################
